############################################################
#..........................................................#
#..........................................................#
#..........................................................#
#..........................................................#
#..........................................................#
#####..............######################..............#####
#..........................................................#
#..........................................................#
#..........................................................#
#..........................................................#
#..........##############..........##############..........#
#..........................................................#
#..........................................................#
#..........................................................#
#..........................................................#
#####..............######################..............#####
#..........................................................#
#..........................................................#
#..........................................................#
#..........................................................#
#..........##############..........##############..........#
#..........................................................#
#..........................................................#
#..........................................................#
#..........................................................#
############################################################